螢幕	屏幕
網路	網絡
訊號	信號
資訊	信息
智慧型手機	智能手機
繁體中文	簡體中文
記憶體	內存
咖哩	咖喱
程式碼	源代碼
程式	程序
硬碟	硬盤
駭	黑
驚滔黑浪	驚滔駭浪
資料庫	數據庫
數位	數字
在地化	本地化
軟體	軟件
軟件章魚	軟體章魚
硬體	硬件
搜尋引擎	搜索引擎
胺基酸	氨基酸
維他命	維生素
著	着
着名	著名
着作	著作
顯示著	顯示着
透過	通過
通過窗戶	透過窗戶
通過後車窗	透過後車窗
通過玻璃	透過玻璃
通過小窗	透過小窗
奈米	納米
1:F	1: F
2:S	2: S
3:S	3: S
4:M	4: M
